......................................+.................
........................................................
........................................................
........................................................
........................................................
........................................................
........................................................
........................................................
........................................................
........................................................
........................................................
........................................................
........................................................
....................................#...#...............
....................................#...#...............
....................................#...#...............
..................................###...########........
..................................#............#........
..................................#............#........
..................................#............#........
..................................##############........
........................................................
........................................................
........................................................
..........................#..........#..................
..........................############..................
........................................................
........................................................
...........................#............................
.................###########............................
........................................................
........................................................
...........................#............................
...........................#.#..........................
...........................#.#.#........................
...........................#.#.#........................
...........................#.#.#........................
...........................#.#.#........................
.........................#.#.#.#........................
.........................#.#.#.#........................
.........................#.#.#.#........................
.......................#.#.#.#.#........................
.......................#########........................
........................................................
........................................................
...................######...............................
........................................................
................######.######...........................
........................................................
.............######.######.######.......................
........................................................
........................................................
.........######.........................................
........................................................
......######.######.....................................
........................................................
...######.######.######.................................
........................................................
######.######.######.######.............................
........................................................
........................................................
................................#...#...................
................................#...#...................
............................#####...##..................
............................#........#..................
............................#........#..................
............................#........#..................
............................#........#..................
............................#........#..................
............................#........#..................
............................##########..................
........................................................
........................................................
.........................#####..........................
........................................................
........................................................
......................#####.#####.......................
........................................................
........................................................
...................#####.#####.#####....................
........................................................
........................................................
................#####.#####.#####.#####.................
........................................................
........................................................
.............#####.#####.#####.#####.#####..............
........................................................
........................................................
........................................................
........................................................
........#.#.............................................
........#.#.............................................
........#.#.#...........................................
........#.#.#...........................................
........#.#.#...........................................
........#.#.#...........................................
......#.#.#.#...........................................
......#.#.#.#.#.#.......................................
......###########.......................................
........................................................
........................................................
........................................................
........................................................
.......#..............#.................................
.......################.................................
........................................................
........................................................
....................######..............................
........................................................
.................######.######..........................
........................................................
..............######.######.######......................
........................................................
...........######.######.######.######..................
........................................................
........................................................
........................................................
.................................#......................
.................................#......................
.................................#.....#................
.................................#.....#................
.................................#.....#................
.................................#...#.#...#............
...............................#.#.#.#.#...#............
...............................#.#.#.#.#...#............
...............................#.#.#.#.#.#.#............
...............................#############............
........................................................
........................................................
...........................................#...#........
...........................................#...#........
..........................................##...#########
..........................................#............#
..........................................#............#
..........................................#............#
..........................................##############
........................................................
........................................................
......................................#.....#...........
......................................#.....#...........
......................................#.....#...........
......................................#.....#...........
....................................###.....########....
....................................#..............#....
....................................#..............#....
....................................#..............#....
....................................################....
........................................................
...........................#...........#................
...........................#############................
........................................................
........................................................
........................................................
..................................#.....................
................#.................#.....................
................#.......#.........#.....................
................#...#...#.........#.....................
................#...#...#.........#.....................
................#...#...#...#...#.#.....................
................#.#.#...#.#.#.#.#.#.....................
................#.#.#...#.#.#.#.#.#.....................
................#.#.#.#.#.#.#.#.#.#.....................
................###################.....................

